1 1 0 0 0 0 0 0 0 1 1
1 1 1 0 0 0 0 0 1 1 1
1 1 1 1 0 0 0 1 1 1 1
1 1 1 1 1 0 1 1 1 1 1
1 1 1 1 1 1 1 1 1 1 1
1 1 1 1 1 0 1 1 1 1 1
1 1 1 1 0 0 0 1 1 1 1
1 1 1 1 0 0 0 1 1 1 1
1 1 1 0 0 0 0 0 1 1 1
- 1 - 0 - 0 - 0 - 1 -
C|4|-3|
C|4|-5|
C|-6|0|
C|-6|1|
C|-3|3|
R|3|3|
R|3|2|
G|3|4|
T|1|0|
E|4|3|
P|-4|2|