1 1 1 1 1 1 1 1 1 1 1
1 1 0 0 1 0 0 1 0 0 1
1 1 0 1 1 1 1 1 1 1 1
1 1 1 1 0 0 1 0 0 1 1
1 1 1 1 0 0 1 0 0 1 1
1 1 1 1 1 1 1 1 1 1 1
1 1 0 0 1 0 0 1 1 1 1
1 1 0 0 1 0 0 1 1 1 1
1 1 1 1 1 1 1 1 1 1 1
- 1 - 1 - 1 - 1 - 1 -
C|3|0|
C|2|2|
R|-2|3|
T|-4|-1|
E|4|2|
P|-3|2|