1 1 1 1 1 1 1 1 1 1 1
1 1 1 1 1 1 1 1 1 1 1
1 1 1 0 1 1 1 0 1 1 1
1 1 1 0 1 1 1 0 1 1 1
1 1 1 0 1 1 1 0 1 1 1
1 1 1 0 1 1 1 0 1 1 1
1 1 1 0 1 1 1 0 1 1 1
1 1 1 0 1 1 1 0 1 1 1
1 1 1 1 1 1 1 1 1 1 1
- 1 - 1 - 1 - 1 - 1 -
C|4|-3|
C|4|-5|
C|-6|0|
C|-5|-1|
R|-1|0|
T|0|0|
E|4|-4|
P|-4|2|