1 1 1 1 1 1 1 1 1 1 1
1 1 0 0 1 0 1 0 0 1 1
1 1 1 1 1 0 1 1 1 1 1
1 1 1 1 1 0 1 1 1 1 1
1 1 1 1 1 1 1 1 1 1 1
1 1 0 1 1 0 1 1 0 1 1
1 1 1 0 1 0 1 0 1 1 1
1 1 1 1 1 0 1 1 1 1 1
1 1 1 1 1 1 1 1 1 1 1
- 1 - 1 - 1 - 1 - 1 -
C|4|-3|
C|4|-5|
R|0|-1|
C|-2|1|
R|-3|5|
T|-5|5|
E|1|-4|
P|-4|2|